16 63
###############################################################
#*************************************************************#
#*************************************************************#
#*************************************************************#
#*************************************************************#
#*************************************************************#
#****************************##*******************************#
#**************************######*****************************#
#**************************######*****************************#
#****************************##*******************************#
#*************************************************************#
#*************************************************************#
#*************************************************************#
#*************************************************************#
#*************************************************************#
###############################################################